aa	aa	aa
baa	b	aa
caa	c	aa
daa	d	aa
faa	f	aa
gaa	g	aa
gwaa	g	aa
haa	h	aa
jaa	j	aa
kaa	k	aa
kwaa	k	aa
laa	l	aa
maa	m	aa
naa	n	aa
ngaa	ng	aa
paa	p	aa
saa	s	aa
taa	t	aa
waa	w	aa
zaa	z	aa
aai	aa	aai
baai	b	aai
caai	c	aai
daai	d	aai
faai	f	aai
gaai	g	aai
gwaai	g	aai
haai	h	aai
jaai	j	aai
kaai	k	aai
kwaai	k	aai
laai	l	aai
maai	m	aai
naai	n	aai
ngaai	ng	aai
paai	p	aai
saai	s	aai
taai	t	aai
waai	w	aai
zaai	z	aai
aau	aa0	aau
baau	b	aau
caau	c	aau
gaau	g	aau
haau	h	aau
kaau	k	aau
laau	l	aau
maau	m	aau
naau	n	aau
ngaau	ng	aau
paau	p	aau
saau	s	aau
zaau	z	aau
aam	aa	aam
caam	c	aam
daam	d	aam
gaam	g	aam
haam	h	aam
laam	l	aam
naam	n	aam
ngaam	ng	aam
saam	s	aam
taam	t	aam
zaam	z	aam
aan	aa	aan
baan	b	aan
caan	c	aan
daan	d	aan
faan	f	aan
gaan	g	aan
haan	h	aan
laan	l	aan
maan	m	aan
naan	n	aan
ngaan	ng	aan
paan	p	aan
saan	s	aan
taan	t	aan
waan	w	aan
zaan	z	aan
aang	aa0	aang
baang	b	aang
caang	c	aang
gaang	g	aang
gwaang	g	aang
haang	h	aang
kwaang	k	aang
laang	l	aang
maang	m	aang
ngaang	ng	aang
paang	p	aang
saang	s	aang
waang	w	aang
zaang	z	aang
aap	aa	aap
caap	c	aap
daap	d	aap
gaap	g	aap
haap	h	aap
laap	l	aap
naap	n	aap
ngaap	ng	aap
saap	s	aap
taap	t	aap
zaap	z	aap
aat	aa	aat
baat	b	aat
caat	c	aat
faat	f	aat
gaat	g	aat
gwaat	g	aat
kaat	k	aat
laat	l	aat
maat	m	aat
naat	n	aat
ngaat	ng	aat
saat	s	aat
taat	t	aat
waat	w	aat
zaat	z	aat
aak	aa	aak
baak	b	aak
caak	c	aak
daak	d	aak
faak	f	aak
gaak	g	aak
gwaak	g	aak
haak	h	aak
jaak	j	aak
kaak	k	aak
laak	l	aak
maak	m	aak
ngaak	ng	aak
paak	p	aak
saak	s	aak
waak	w	aak
zaak	z	aak
ai	a	ai
bai	b	ai
cai	c	ai
dai	d	ai
fai	f	ai
gai	g	ai
gwai	g	ai
hai	h	ai
jai	j	ai
kai	k	ai
kwai	k	ai
lai	l	ai
mai	m	ai
nai	n	ai
ngai	ng	ai
pai	p	ai
sai	s	ai
tai	t	ai
wai	w	ai
zai	z	ai
au	a	au
bau	b	au
cau	c	au
dau	d	au
fau	f	au
gau	g	au
hau	h	au
jau	j	au
kau	k	au
lau	l	au
mau	m	au
nau	n	au
ngau	ng	au
pau	p	au
sau	s	au
tau	t	au
zau	z	au
am	a	am
bam	b	am
cam	c	am
dam	d	am
gam	g	am
ham	h	am
jam	j	am
kam	k	am
lam	l	am
nam	n	am
ngam	ng	am
sam	s	am
tam	t	am
zam	z	am
ban	b	an
can	c	an
dan	d	an
fan	f	an
gan	g	an
gwan	g	an
han	h	an
jan	j	an
kan	k	an
kwan	k	an
man	m	an
nan	n	an
ngan	ng	an
pan	p	an
san	s	an
tan	t	an
wan	w	an
zan	z	an
ang	a	ang
bang	b	ang
cang	c	ang
dang	d	ang
fang	f	ang
gang	g	ang
gwang	g	ang
hang	h	ang
kang	k	ang
lang	l	ang
mang	m	ang
nang	n	ang
ngang	ng	ang
pang	p	ang
sang	s	ang
tang	t	ang
wang	w	ang
zang	z	ang
ap	a	ap
cap	c	ap
dap	d	ap
gap	g	ap
hap	h	ap
jap	j	ap
kap	k	ap
lap	l	ap
nap	n	ap
ngap	ng	ap
sap	s	ap
zap	z	ap
bat	b	at
cat	c	at
dat	d	at
fat	f	at
gat	g	at
gwat	g	at
hat	h	at
jat	j	at
kat	k	at
lat	l	at
mat	m	at
nat	n	at
ngat	ng	at
pat	p	at
sat	s	at
wat	w	at
zat	z	at
ak	a	ak
bak	b	ak
cak	c	ak
dak	d	ak
hak	h	ak
lak	l	ak
mak	m	ak
ngak	ng	ak
sak	s	ak
zak	z	ak
e	e	e
be	b	e
ce	c	e
de	d	e
fe	f	e
ge	g	e
je	j	e
ke	k	e
le	l	e
me	m	e
ne	n	e
se	s	e
ze	z	e
ei	ei	ei
bei	b	ei
dei	d	ei
fei	f	ei
gei	g	ei
hei	hx	ei
kei	k	ei
lei	l	ei
mei	m	ei
nei	n	ei
pei	p	ei
sei	s	ei
deu	d	eu
lem	l	em
beng	b	eng
ceng	c	eng
deng	d	eng
geng	g	eng
heng	hx	eng
jeng	j	eng
leng	l	eng
meng	m	eng
peng	p	eng
seng	s	eng
teng	t	eng
zeng	z	eng
gep	g	ep
bek	b	ek
cek	c	ek
dek	d	ek
hek	hx	ek
kek	k	ek
lek	l	ek
pek	p	ek
sek	s	ek
tek	t	ek
zek	z	ek
ci	c	i
ji	i	i
li	l	i
mi	m	i
ni	n	i
si	s	i
zi	z	i
biu	b	iu
ciu	c	iu
diu	d	iu
giu	g	iu
hiu	hh	iu
jiu	i	iu
kiu	k	iu
liu	l	iu
miu	m	iu
niu	n	iu
piu	p	iu
siu	s	iu
tiu	t	iu
ziu	z	iu
cim	c	im
dim	d	im
gim	g	im
him	hh	im
jim	i	im
kim	k	im
lim	l	im
nim	n	im
sim	s	im
tim	t	im
zim	z	im
bin	b	in
cin	c	in
din	d	in
gin	g	in
hin	hh	in
jin	i	in
kin	k	in
lin	l	in
min	m	in
nin	n	in
pin	p	in
sin	s	in
tin	t	in
zin	z	in
bing	b	ing
cing	c	ing
ding	d	ing
ging	g	ing
gwing	g	ing
hing	hx	ing
jing	j	ing
king	k	ing
ling	l	ing
ming	m	ing
ning	n	ing
ping	p	ing
sing	s	ing
ting	t	ing
wing	w	ing
zing	z	ing
cip	c	ip
dip	d	ip
gip	g	ip
hip	hh	ip
jip	i	ip
lip	l	ip
nip	n	ip
sip	s	ip
tip	t	ip
zip	z	ip
bit	b	it
cit	c	it
dit	d	it
git	g	it
hit	hh	it
jit	i	it
kit	k	it
lit	l	it
mit	m	it
ngit	ng	it
sit	s	it
tit	t	it
zit	z	it
bik	b	ik
cik	c	ik
dik	d	ik
gik	g	ik
gwik	g	ik
hik	hx	ik
jik	j	ik
kik	k	ik
kwik	k	ik
lik	l	ik
mik	m	ik
nik	n	ik
pik	p	ik
sik	s	ik
tik	t	ik
wik	w	ik
zik	z	ik
o	o	o
bo	b	o
co	c	o
do	d	o
fo	f	o
go	g	o
gwo	g	o
ho	h0	o
jo	j	o
ko	k	o
lo	l	o
mo	m	o
no	n	o
ngo	ng	o
po	p	o
so	s	o
to	t	o
wo	w	o
zo	z	o
oi	o	oi
coi	c	oi
doi	d	oi
goi	g	oi
hoi	h0	oi
koi	k	oi
loi	l	oi
noi	n	oi
ngoi	ng	oi
poi	p	oi
soi	s	oi
toi	t	oi
zoi	z	oi
ou	ou	ou
bou	b	ou
cou	c	ou
dou	d	ou
gou	g	ou
hou	h0	ou
lou	l	ou
mou	m	ou
nou	n	ou
ngou	ng	ou
pou	p	ou
sou	s	ou
tou	t	ou
zou	z	ou
on	o	on
gon	g	on
hon	h0	on
ngon	ng	on
ong	o0	ong
bong	b	ong
cong	c	ong
dong	d	ong
fong	f	ong
gong	g	ong
gwong	g	ong
hong	h0	ong
kong	k	ong
kwong	k	ong
long	l	ong
mong	m	ong
nong	n	ong
ngong	ng	ong
pong	p	ong
song	s	ong
tong	t	ong
wong	w	ong
zong	z	ong
got	g	ot
hot	h0	ot
ok	o0	ok
bok	b	ok
cok	c	ok
dok	d	ok
fok	f	ok
gok	g	ok
gwok	g	ok
hok	h0	ok
kwok	k	ok
lok	l	ok
mok	m	ok
nok	n	ok
ngok	ng	ok
pok	p	ok
sok	s	ok
tok	t	ok
wok	w	ok
zok	z	ok
doe	d	oe
goe	g	oe
hoe	hy	oe
koe	k	oe
toe	t	oe
coeng	cy	oeng
goeng	g	oeng
hoeng	hy	oeng
joeng	jy	oeng
koeng	k	oeng
loeng	ly	oeng
noeng	ny	oeng
soeng	sy	oeng
zoeng	zy	oeng
coek	cy	oek
doek	d	oek
goek	g	oek
joek	jy	oek
koek	k	oek
loek	ly	oek
soek	sy	oek
zoek	zy	oek
ceoi	cy	eoi
deoi	d	eoi
geoi	g	eoi
heoi	hy	eoi
jeoi	jy	eoi
keoi	k	eoi
leoi	ly	eoi
neoi	ny	eoi
seoi	sy	eoi
teoi	t	eoi
zeoi	zy	eoi
ceon	cy	eon
deon	d	eon
jeon	jy	eon
leon	ly	eon
seon	sy	eon
teon	t	eon
zeon	zy	eon
ceot	cy	eot
deot	d	eot
leot	ly	eot
neot	ny	eot
seot	sy	eot
zeot	zy	eot
fu	f	u
gu	g	u
ku	k	u
wu	u	u
bui	b	ui
fui	f	ui
gui	g	ui
kui	k	ui
mui	m	ui
pui	p	ui
wui	u	ui
bun	b	un
fun	f	un
gun	g	un
mun	m	un
pun	p	un
wun	u	un
ung	ung	ung
bung	b	ung
cung	c	ung
dung	d	ung
fung	f	ung
gung	g	ung
hung	h0	ung
jung	j	ung
kung	k	ung
lung	l	ung
mung	m	ung
nung	n	ung
ngung	ng	ung
pung	p	ung
sung	s	ung
tung	t	ung
zung	z	ung
but	b	ut
fut	f	ut
kut	k	ut
mut	m	ut
put	p	ut
wut	u	ut
uk	o	uk
buk	b	uk
cuk	c	uk
duk	d	uk
fuk	f	uk
guk	g	uk
huk	h0	uk
juk	j	uk
kuk	k	uk
luk	l	uk
muk	m	uk
nuk	n	uk
nguk	ng	uk
puk	p	uk
suk	s	uk
tuk	t	uk
zuk	z	uk
cyu	cy	yu
jyu	yu	yu
syu	sy	yu
zyu	zy	yu
cyun	cy	yun
dyun	d	yun
gyun	g	yun
hyun	hy	yun
jyun	yu	yun
kyun	k	yun
lyun	ly	yun
nyun	ny	yun
syun	sy	yun
tyun	t	yun
zyun	zy	yun
cyut	cy	yut
dyut	d	yut
gyut	g	yut
hyut	hy	yut
jyut	yu	yut
kyut	k	yut
lyut	ly	yut
syut	sy	yut
tyut	t	yut
zyut	zy	yut
m	m	m
n	n	n
ng	ng	ng
